0000000000000
0020000000200
0002000002000
0005555555000
0055055505500
0555555555550
0301111111030
0303000003030
0000440440000