555555555555555
555555555555555
444440000044444
414140010041414
333330000033333
331333333333133
222222222222222
222222222222222